00000000
00011112
00010000
00011100
00000100
00011100
00010000
01110000
02000000