00020000
00010000
00011100
00000100
00011100
00010000
01110000
01000000
01111112