00000000
00000012
21100010
00100010
00111010
00001010
01111010
01000010
01111110